RRRRRRRRRRRRRRRRRRRRRRRRRRRRRRRRRRRRRRRRRRRRRRRRRR
R................................................R
R................................................R
R.............B..B......B..B......B..B...........R
R................................................R
R...C...C...C...C...C...C...C...C...C...C...C....R
R.....B..B....B...B..B....B..B.....B..B....B..B..R
R.....B..B......B..B......B..B...................R
R..B...B....B..B....B...B..B....B..B.....B..B....R
R...C...C...C...C...C...C...C...C...C...C...C....R
R.....B..B....B...B..B....B..B.....B..B....B..B..R
R.....B..B......B..B......B..B...................R
R..B...B....B..B....B...B..B....B..B.....B..B....R
R...C...C...C...C...C...C...C...C...C...C...C....R
R.....B..B....B...B..B....B..B.....B..B....B..B..R
R.....B..B......B..B......B..B...................R
R..B...B....B..B....B...B..B....B..B.....B..B....R
R...C...C...C...C...C...C...C...C...C...C...C....R
R.....B..B....B...B..B....B..B.....B..B....B..B..R
R.....B..B......B..B......B..B...................R
R..B...B....B..B....B...B..B....B..B.....B..B....R
R...C...C...C...C...C...C...C...C...C...C...C....R
R.....B..B....B...B..B....B..B.....B..B....B..B..R
R.....B..B......B..B......B..B...................R
R..B...B....B..B....B...B..B....B..B.....B..B....R
R...C...C...C...C...C...C...C...C...C...C...C....R
R.....B..B....B...B..B....B..B.....B..B....B..B..R
R.....B..B......B..B......B..B...................R
R..B...B....B..B....B...B..B....B..B.....B..B....R
R...C...C...C...C...C...C...C...C...C...C...C....R
R.....B..B....B...B..B....B..B.....B..B....B..B..R
R.....B..B......B..B......B..B...................R
R..B...B....B..B....B...B..B....B..B.....B..B....R
R................................................R
RRRRRRRRRRRRRRRRRRRRRRRRRRRRRRRRRRRRRRRRRRRRRRRRRR