RRRRRRRRRRRRRRRRRRRRRRRRRRRRRRRRRRRRRRRRRRRRRRRRRR
R............CBCBCBCBCBCBCBCBCBCBCBCBCBBR........R
R................................................R
R..CBCBCBCBCBCBCBCBCBCBCBCBCBCBCBCBCBCBBRBRBCCBCBR
R..........BBBBBBBBBBBBBBBBBBBBBBBBBBBBBBBBBB....R
RRRRRRRRRRRRRRRRRRRRRRRRRRRRRRRRRRRRRRRRRRRRRRRRRR