
RRRRRRRRRRRRRRRRRRRRRRRRRRRRRRRRRRRRRRRRRRRRRRRRRR
R..@......BBBBBBBBBBBBBBBBBBBBBBBBBBBBBBBBBBBBBBBR
R...BBBBBBBBBBBBBBBBBBBBBBBBBBBBBBBBBBBBB........R
R..CBCBCBCBCBCBCBCBCBCBCBCBCBCBCBCBCBCBBRBRBCCBCBR
R...BBBBBBBBBBBBBBBBBBBBBBBBBBBBBBBBBBBBBBBBBBBBBR
R...BBBBBBBBBBBBBBBBBBBBBBBBBBBBBB...............R
R...BCBCBBCBC..........BCBCBBCBCBCBCBC...........R
RBBBBBBBBBBBBBB.....BBBBBBBBBBBBBBBBBBBBBBBBBBBBBR
RCBCBCBCBCBCCCBC....BCBCBCBCBCBCBCBCBBCBCBCBCBCBCR
RBBBBBBBBBBBBBBB...BBBBBBBBBBBBBBBBBBBBBBBBBBBBBBR
RCCCCCCBBBBBBBBBBCCCCBBBCBCBCBBBCCCBBBCCCBCCCBBBCR
RBBBBBBBBBBBBBBBBBBBBBBBBBBBBBBBBBBBBBBBBBBBBBBBBR
RBBBBBBBBBBBBBBBB................................R
R...CBCBCBCBCBCBCBCBCBCBCBCBCCBCBC...............R
R...BBBBBBBBBBBBBBBBBBBBBBBBBBBBBBBB.............R
R...CBCBCBCBCBCBCBCBCBCBCBCBCBCCBCBCBC.........CBR
R...BBBBBBBBBBBBBBBBBBBBBBBBBBBBBBBBBBB.......BBBR
R...C.C.C.C.C.C.C.C.C.CCCC....CCCCC...CC.....CC..R
R................................................R
R...CCC...CCC...CCC...CCC...CCC...CCC...CCC...CCCR
R................................................R
R...C.C.C.C.C.C.C.C.C.CCCC....CCCCC...CC.....CC..R
R...BBBBBBBBBBBBBBBBBBBBBBBBBBBBBBBBBBB.......BBBR
R...CBCBCBCBCBCBCBCBCBCBCBCBCBCCBCBCBC.........CBR
R...BBBBBBBBBBBBBBBBBBBBBBBBBBBBBBBB.............R
R...CBCBCBCBCBCBCBCBCBCBCBCBCCBCBC...............R
RBBBBBBBBBBBBBBBB................................R
RBBBBBBBBBBBBBBBBBBBBBBBBBBBBBBBBBBBBBBBBBBBBBBBBR
RCCCCCCBBBBBBBBBBCCCCBBBCBCBCBBBCCCBBBCCCBCCCBBBCR
RBBBBBBBBBBBBBBB...BBBBBBBBBBBBBBBBBBBBBBBBBBBBBBR
RCBCBCBCBCBCCCBC....BCBCBCBCBCBCBCBCBBCBCBCBCBCBCR
RBBBBBBBBBBBBBB.....BBBBBBBBBBBBBBBBBBBBBBBBBBBBBR
R...BCBCBBCBC..........BCBCBBCBCBCBCBC...........R
R...BBBBBBBBBBBBBBBBBBBBBBBBBBBBBB...............R
R...BBBBBBBBBBBBBBBBBBBBBBBBBBBBBBBBBBBBBBBBBBBBBR
R..CBCBCBCBCBCBCBCBCBCBCBCBCBCBCBCBCBCBBRBRBCCBCBR
R...BBBBBBBBBBBBBBBBBBBBBBBBBBBBBBBBBBBBB........R
R.........BBBBBBBBBBBBBBBBBBBBBBBBBBBBBBBBBBBBBBBR
RRRRRRRRRRRRRRRRRRRRRRRRRRRRRRRRRRRRRRRRRRRRRRRRRR