RRRRRRRRRRRRRRRRRRRRRRRRRRRRRRRRRRRRRRRRRRRRRRRRRR
R............CBCBCBCBCBCBCBCBCBCBCBCBCBBR........R
R................................................R
R..CBCBCBCBCBCBCBCBCBCBCBCBCBCBCBCBCBCBBRBRBCCBCBR
R................................................R
RRRRRRRRRRRRRRRRRRRRRRRRRRRRRRRRRRRRRRRRRRRRRRRRRR